111111111
100010001
101111001
100P00001
100000011
111111111
