1111111
1000001
100P001
1000001
1000001
1000011
1111111
